R 1366 768
S1 ./textures/wall1h.xpm
S2 ./textures/wall2h.xpm
S3 ./textures/WE.xpm
S4 ./textures/EA.xpm
S5 ./textures/table1.xpm
S6 ./textures/torch_i.xpm
S7 ./textures/torch_i.xpm
S8 ./textures/skeleton1.xpm
F  60,60,60 
C  100,140,220
map:
        1111111111111111111111111
        1000000000110000000000001
        1011000001110000000000001
        1001000000000700550550001
111111111011000001110000000000001
100000000011000001110111010111111
11110111111111011200000210001
11110111111111011202020210001
11000000110101011200000210001
10000000000000001200000210001
10000000000000001282028210001
11000001110101011122822110N01
11117111 1110101 101211010001
11111111 1111111 111111111111