

NO ./textures/brick.xpm
SO ./textures/blue.xpm
WE ./textures/wood.xpm
EA ./textures/grey.xpm

F 100,1,100
C 10,10,10


111111111111111111111111111
10000R0000000W000000000001
111111111111111111111111111






