R 1366 768
NO ./textures/NO.xpm
SO ./textures/SO.xpm
WE ./textures/WE.xpm
EA ./textures/EA.xpm
S ./textures/table1.xpm
F  60,60,60 
C  100,200,220
        1111111111111111111111111
        1000000000110000000000001
        1011000001110020202020001
        1001000000000002020200001
111111111011000001110000000000001
100000000011000001110111010111111
11110111111111011100000012021
11110111111111011101010010001
11000000110101011100000010001
10002000000000001100000010001
10000000000000001101010010001
11000001110101011111011110N01
11110111 1110101 101111012021
11111111 1111111 111111111111