R 1600 1000
S1 ./textures/wall1h.xpm
S2 ./textures/wall2h.xpm
S3 ./textures/SO.xpm
S4 ./textures/EA.xpm
S5 ./textures/table1.xpm
S6 ./textures/torch_i.xpm
S7 ./textures/torch_i.xpm
S8 ./textures/skeleton1.xpm
F  5,5,5 
C  22,15,15

map:
22222222222222222222222222222222
20702008220000022000200022222222
20002008220555022000200022222222
20002008220000022000200022222222
20002202222228022202220222222222
2E000000002228022700000020002222
20002202202228022055550000002222
20002008202220022000000020002222
20002008200000000055550022222222
20002008202222222000000020000022
20002222202000222055550000002022
22222222202020222000000027002022
20000000000020222222222222222022
20002222202020202000000020000022
20002002202000272020202020202022
20002002202222202000000020000022
20002202000200002000000020000022
20002202000200002000000020202022
20000002222200002000000020000022
20002222222200202222022222202222
20000000000000000000022222202222
22222222222222222222222222232222
